NO download-WeResize.com.xpm
SO rachid.xpm
WE textures/wall_west.xpm
EA textures/wall_east.xpm
F 220,100,0
C 225,30,0

1111111111111111111111111111111
10000S0000110000000000001000001
1011000001110000000000001000001
1001000000000000000000000000001
1111111110110000011100001000001
100000000011000001110111111111111
11110111111111011100000010001
11110111111111011101010000001
11000000110101011100000010001
10000000000000001100000010001
10000000000000001101010010001
110000011101010111110111100111
11110111111101011101111010001
11111111111111111111111111111
